1111111111111111111111111
1000000000000000000000001
1000000000000000000000001
100000000000000n000000001
1111111111111111111111111
